555555555555555555
599999999999999995
500000000000000005
500000000000000005
599999999999099995
500000000000000005
500000000000000005
599909999999999995
500000000000000005
500000000000000005
555555555555555555